NO ./res/br.png
SO ./res/br2.png
WE ./res/br3.png
EA ./res/br4.png

d ./res/door_open_pixel.png
D ./res/door_closed_pixel.png

F 50, 10, 30
C 44, 44, 44

1111111111111 111111
10N000000000010001111
1000000000000000001
10000100100011100001
11111100111111110111
      1000000000001
       11111101111
           10001
           11111
