NO ./res/NORTH.xpm
SO ./res/SOUTH.xpm
EA ./res/EAST.xpm
WE ./res/WEST.xpm
F 20, 20, 20
C 30, 15, 15

1111111111111111111111111111111111111111
1000000000000000000000000000000000000001
1000000000000000000000000000000000000001
1000000000000000000000000000000000000001
10000011111111111111111111111111110000011111111111111111111
1000001                          10000000000000000000000001
1000001                          10000000000000000000000001
1000001                          10000011111111111111100001
1000001111111111111111111111111111000001             100001
1000000000000000000000000000000000000001             100001
1000000000000000000000000000000000000001             100001
1000000000000000000000000000000000000001             100001
1000000000000000000000000000000000000001             100001
1000000000000000000000000000000000000001             100001
1000000000000000000000000000000000000001             100001
1000000000000000000000000000000000000001             100001
1000000000000000000000000000000000000001             100001
1111111111111000111111111111111111111111             100001
            10001                                    100001
            10001                                    100001
            10001                                    100001
            10001                                    100001
            10001                                    100001
            10001                                    100001
            10001                                    100001
    11111111100011111111111111111                    100001
    10000000000000000000000000001                    100001
    100000000000000N00000000000011111111111111111111110000111111111111111111111111111111111
    10000000000000000000000000000000000000000000000000000000000000000000000000000000000001
    100000000000000000000000000000000000000000000000000000000000000000000000000000000000001
    111111111111111111111111111111111111110000111111111111111111111100000000001111111110001
                                         100001                    100000000001       10001
                                         100001                    100000000001       10001
                                         100001                    100000000001       10001
                                         10000111111111111111111111100000000001       10001
                                         10000000000000000000000000000000000001       10001
                                         10000111100111111111100111100000000001       10001
                                         100001  1001        1001  100000000001       10001
                                         10000111100111111111100111100000000001       10001
                                         10000000000000000000000000000000000001       10001
                                         10000111111111111111111111100000000001       10001
                                         100001                    100000000001       10001
                                         10000111111111111111111111100000000001       10001
                                         10000000000000000000000000000000000001       10001
                                         10000111111111100011111111100000000001       10001
                                         100001        10001       100000000001       10001
                                         100001        10001       100000000001       10001
                                         10000111111111100011111111100000000001111111110001
1111111111111111111111111111111111111111110000000000000000000000000000000000000000000000001
1000000000000000000000000000000000000000000000000011111111111111111111111111111111111111111
100011111111111111111111111111111111111111111111111
10001
11111
